1111111111111111111111111111111111
10000C000000010000000C00010000C001
1010010100100000101001000000010101
1000010010000100001000010010010101
1E0000000C00000000P0000000001000C1
1111111111111111111111111111111111